w, w, w, w, w, w, w, w, w, w, w, w, w,
w, p, f, f, f, f, f, f, f, f, f, h, w,
w, f, e.6, f, f, f, f, f, f, j.-.1, h,	w, w,
w, f, f, j.+.3, f, f, f, f, f, h,	w, w, w,
w, f, f, w, f, f, f, f, h,	w, w, w, w,
w, f, f, f, f, f, j.-.3, h,	w, w, w, w, w,
w, f, f, w, f, f, h,	w, w, w, w, w, w,
w, f, f, f, j.+.1, h,	w, w, w, w, w, w, w,
w, h, f, j.+.1, h,	w, w, w, w, w, w, w, w,
w, f, e.2, h,	w, w, w, w, w, w, w, w, w,
w, e.2, h,	w, w, w, w, w, w, w, w, w, w,
w, h,	w, w, w, w, w, w, w, w, w, w, w,
w,	w, w, w, w, w, w, w, w, w, w, w, w,